R 1080 720

NO ./tex/city/wall1.xpm
SO ./tex/city/wall2.xpm
WE ./tex/city/wall3.xpm
EA ./tex/city/wall4.xpm
S ./tex/pnj.xpm
BG ./tex/night3.xpm
TF ./tex/city/ground.xpm
DR ./tex/city/door.xpm

F 117, 142, 79
C 135, 245, 251

111111111111111111111111111
100020000020000000000000001
100000000000020000000020001
111100N01111000011110000111
   100001  100001  100001
   100001  100001111000011111111
   100001  100200000000000000001
   100001  100000000000011111101
   100001  11111111111111    101
   100001                    101
   100001                    101
   10000111111111111111111111101
   10000000000000020000000000001
   10020000000000000000000001111
   11111100001111111110000111
        100001       100001
        1000011111111100001
        1000000000000000001
        1111111111111111111
