R 1920 1080

NO ./tex/greystone.xpm
SO ./textures/colorstone.xpm
WE ./textures/greystone.xpm
EA ./textures/redbrick.xpm
S ./textures/pillar.xpm

F 117, 142, 79
C 135, 245, 251

11111111
10000001
11100001
  100001
11100001
10000001
11111111
