R 1032 516

NO ./textures/bluestone.xpm
SO ./textures/colorstone.xpm
WE ./textures/greystone.xpm
S ./textures/pillar.xpm

F 117, 142, 79
C 135, 245, 251

11111111           
10000001           
10000001           
1000000111111111111
1000000000000000001
1000000000000000001
1000000000000000001
1111111100000000001
       100000S00001
       100000000001
       111111111111
