R 1032 516

NO ./tex/quartz_block_top.xpm
SO ./tex/quartz_pillar.xpm
WE ./tex/quartz_pillar_top.xpm
EA ./tex/smithing_table_bottom.xpm
S ./textures/pillar.xpm

F 117, 142, 79
C 135, 245, 251

11111111
10000001
100E0001
1000000111111111111
1000000000000000001
1000000000000000001
1000000000000000001
1111111100000000001
       100000000001
       100000000001
       111111111111
