R 640 480

NO ./tex/stone_bricks.xpm
SO ./tex/smoker_bottom.xpm
WE ./tex/sandstone.xpm



EA ./tex/red_sandstone.xpm
S ./tex/pnj.xpm
BG ./tex/bg.xpm
TF ./tex/dark_oak_planks.xpm

SA ./tex/warped_roots.xpm
SB ./tex/warped_roots_mov.xpm

F 117, 142, 79
C 135, 245, 251

1111111111
1000000201
1111000001
1000000001
1020001001
1020001021
1000001001
1111111111
